Madalina 
+---+---+---+---+---+---+---+---+---+---+
|   |               |       |           |
+   +   +   +---+   +   +---+---+---+   +
|       |   |       |   |       |       |
+   +   +   +---+---+   +   +---+   +   +
|   |   |               |   |       |   |
+---+   +   +---+   +---+   +   +---+---+
|       |   |       |                   |
+   +---+---+---+   +---+---+   +   +   +
|       |       |   |           |   |   |
+---+---+---+   +   +---+---+---+   +---+
|       |       |       |               |
+---+   +---+   +---+   +---+---+   +   +
|   |                   |       |   |   |
+   +---+---+   +---+---+---+   +---+   +
|                               |       |
+   +   +---+   +---+---+   +   +   +---+
|   |   |   |   |           |   |       |
+   +   +   +   +---+   +---+   +---+   +
|   |   |       |           |           |
+---+---+---+---+---+---+---+---+---+---+
